
NO    ./path_to_the_north_texture
   SO   ./path_to_the_south_texture
                                        WE        ./path_to_the_west_texture
EA  ./path_to_the_east_texture

F    255   , 000255  ,  0

C 225,    0255   ,     0000000255


111111111 111111111
1111111111111111111
1000000000000000001
1111111111111111101
1000000001000000101
1111111101011111101
1S00000000000000001
1111111111111111111
