




SO dfghcfh





WE 77-550
NO 144
EA 2000



F 250,15,254

C 250,66,011


1111111 111111111111
1101100100000011111
10010000011100000001
10000000000000000011
101101110111001110001
100101 10001001 10011
101111111111111110001
10000000000000000011
11111111000111111001
10000000S0000000001
1111111111111111111 1