




SO dfghcfh





WE 77-550
NO 144
EA 2000



F 250,15,254

C 250,66,011


111111111 111111111
1101101111111101111
1001000000000100001
1011011111111110001
1000000000000000001
1000000010000000001
1111111111111111101
1000000001000000001
1111111101011111101
1000000E00000000001
1111111111111111111