




SO dfghcfh





WE 77-550
NO 144
EA 2000



F 250,15,254

C 250,66,011


111111111 111111111
1101101111111101111
1001000000000000001
1011011111111110001
1000000000000000011
10000000100000001
10000N00000000001
1000000001000000011
1111111101011100001
100000000000000001
1111111111111111111